5 5
FFMFFCCCCC
FFFFCMCCCF
FFCCCCCMMM
FFFFCCMMMM
FFFFFCMMMF