5 5
FFFFFCCCCC
FFFFCCCCCF
FFCCCCCMMM
FFFFCCMMMM
FFFFFCMMMF